PixelColor	KEYWORD1
LedBlinker	KEYWORD1
PixelBlinker	KEYWORD1
r	KEYWORD2
b	KEYWORD2
g	KEYWORD2
getPackedGRB	KEYWORD2
getPackedRGB	KEYWORD2
setPinKEYWORD2
setPolarityKEYWORD2
blink	KEYWORD2
on	KEYWORD2
off	KEYWORD2
onUntil	KEYWORD2
offUntil	KEYWORD2
update	KEYWORD2
setNumPixels	KEYWORD2
setPixel	KEYWORD2
setPixelColor	KEYWORD2
setPixelBrightness	KEYWORD2
setPixelBrightnessPercent	KEYWORD2
